day,h1_diff,day_diff,day_high,day_low,
2019/10/10,41,44,2396,2352,
2019/10/11,31,57,2363,2306,
2019/10/14,51,51,2338,2287,
2019/10/15,19,48,2311,2263,
2019/10/16,28,85,2282,2197,
2019/10/17,21,24,2205,2181,
2019/10/18,21,30,2215,2185,
2019/10/21,48,48,2187,2139,
2019/10/22,12,19,2161,2142,
2019/10/23,31,41,2155,2114,
2019/10/24,23,31,2146,2115,
2019/10/25,14,56,2133,2077,
2019/10/28,15,33,2093,2060,
2019/10/29,16,17,2111,2094,
2019/10/30,18,43,2116,2073,
2019/10/31,13,21,2108,2087,
2019/11/1,21,32,2096,2064,
2019/11/4,23,25,2098,2073,
2019/11/5,30,33,2129,2096,
2019/11/6,19,49,2120,2071,
2019/11/7,34,38,2081,2043,
2019/11/8,25,42,2048,2006,
2019/11/11,31,62,2016,1954,
2019/11/12,19,39,1976,1937,
2019/11/13,17,24,1971,1947,
2019/11/14,25,36,1965,1929,
2019/11/15,20,31,1976,1945,
2019/11/18,22,23,1973,1950,
2019/11/19,23,38,1929,1891,
2019/11/20,16,28,1923,1895,
2019/11/21,11,23,1947,1924,
2019/11/22,15,46,1980,1934,
2019/11/25,22,53,2008,1955,
2019/11/26,16,52,2012,1960,
2019/11/27,12,28,1990,1962,
2019/11/28,28,31,1967,1936,
2019/11/29,23,24,1968,1944,
2019/12/2,19,19,1938,1919,
2019/12/3,17,19,1974,1955,
2019/12/4,14,32,1998,1966,
2019/12/5,14,22,2033,2011,
2019/12/6,22,22,2011,1989,
2019/12/9,20,39,2032,1993,
2019/12/10,9,23,2023,2000,
2019/12/11,15,27,1991,1964,
2019/12/12,13,56,2041,1985,
2019/12/13,21,26,2033,2007,
2019/12/16,16,25,2138,2113,
2019/12/17,24,32,2162,2130,
2019/12/18,22,52,2158,2106,
2019/12/19,9,25,2130,2105,
2019/12/20,15,36,2157,2121,
2019/12/23,21,26,2178,2152,
2019/12/24,21,24,2152,2128,
2019/12/25,15,37,2167,2130,
2019/12/26,10,18,2174,2156,
2019/12/27,27,32,2199,2167,
2019/12/30,39,39,2238,2199,
2019/12/31,29,46,2219,2173,
2020/1/2,28,28,2206,2178,
2020/1/3,12,49,2245,2196,
2020/1/6,41,55,2299,2244,
2020/1/7,22,29,2288,2259,
2020/1/8,63,79,2384,2305,
2020/1/9,48,102,2330,2228,
2020/1/10,14,21,2251,2230,
2020/1/13,64,83,2352,2269,
2020/1/14,34,44,2378,2334,
2020/1/15,33,45,2364,2319,
2020/1/16,19,50,2356,2306,
2020/1/17,20,62,2339,2277,
2020/1/20,27,44,2344,2300,
2020/1/21,29,39,2325,2286,
2020/1/22,46,54,2287,2233,
2020/1/23,21,39,2269,2230,
2020/2/3,33,33,2132,2099,
2020/2/4,70,70,2077,2007,
2020/2/5,42,59,2111,2052,
2020/2/6,25,34,2117,2083,
2020/2/7,19,44,2136,2092,
2020/2/10,33,40,2146,2106,
2020/2/11,40,40,2145,2105,
2020/2/12,20,64,2126,2062,
2020/2/13,31,34,2106,2072,
2020/2/14,24,38,2102,2064,
2020/2/17,21,21,2117,2096,
2020/2/18,22,37,2125,2088,
2020/2/19,27,36,2124,2088,
2020/2/20,19,34,2149,2115,
2020/2/21,18,36,2138,2102,
2020/2/24,61,61,2112,2051,
2020/2/25,23,76,2131,2055,
2020/2/26,24,56,2141,2085,
2020/2/27,25,28,2094,2066,
2020/2/28,48,71,2079,2008,
2020/3/2,42,62,2064,2002,
2020/3/3,27,74,2095,2021,
2020/3/4,25,25,2055,2030,
2020/3/5,17,31,2050,2019,
2020/3/6,23,33,2037,2004,
2020/3/9,0,0,1918,1918,
2020/3/10,105,158,1938,1780,
2020/3/11,24,57,1937,1880,
2020/3/12,70,74,1885,1811,
2020/3/13,41,87,1884,1797,
2020/3/16,27,48,1863,1815,
2020/3/17,29,31,1837,1806,
2020/3/18,32,87,1835,1748,
2020/3/19,62,66,1776,1710,
2020/3/20,37,56,1779,1723,
2020/3/23,35,48,1751,1703,
2020/3/24,20,58,1764,1706,
2020/3/25,35,69,1753,1684,
2020/3/26,40,40,1697,1657,
2020/3/27,67,85,1686,1601,
2020/3/30,38,56,1601,1545,
2020/3/31,45,62,1630,1568,
2020/4/1,30,50,1601,1551,
2020/4/2,52,109,1640,1531,
2020/4/3,52,52,1663,1611,
2020/4/7,35,35,1695,1660,
2020/4/8,32,43,1699,1656,
2020/4/9,44,81,1777,1696,
2020/4/10,40,57,1782,1725,
2020/4/13,74,98,1846,1748,
2020/4/14,64,88,1848,1760,
2020/4/15,46,60,1798,1738,
2020/4/16,56,83,1806,1723,
2020/4/17,32,50,1775,1725,
2020/4/20,42,56,1759,1703,
2020/4/21,62,90,1759,1669,
2020/4/22,42,48,1680,1632,
2020/4/23,38,59,1738,1679,
2020/4/24,27,55,1745,1690,
2020/4/27,31,31,1688,1657,
2020/4/28,38,79,1715,1636,
2020/4/29,31,65,1737,1672,
2020/4/30,26,70,1787,1717,
2020/5/6,69,73,1845,1772,
2020/5/7,16,54,1804,1750,
2020/5/8,23,39,1770,1731,
2020/5/11,24,37,1778,1741,
2020/5/12,18,36,1753,1717,
2020/5/13,28,50,1748,1698,
2020/5/14,16,34,1753,1719,
2020/5/15,23,29,1778,1749,
2020/5/18,26,35,1742,1707,
2020/5/19,19,39,1738,1699,
2020/5/20,11,43,1754,1711,
2020/5/21,16,25,1765,1740,
2020/5/22,24,63,1734,1671,
2020/5/25,21,35,1701,1666,
2020/5/26,18,18,1694,1676,
2020/5/27,22,55,1727,1672,
2020/5/28,19,19,1715,1696,
2020/5/29,27,27,1711,1684,
2020/6/1,21,24,1722,1698,
2020/6/2,11,23,1720,1697,
2020/6/3,11,15,1755,1740,
2020/6/4,11,23,1756,1733,
2020/6/5,14,18,1764,1746,
2020/6/8,19,19,1779,1760,
2020/6/9,12,14,1755,1741,
2020/6/10,14,22,1756,1734,
2020/6/11,9,39,1751,1712,
2020/6/12,24,37,1719,1682,
2020/6/15,16,16,1717,1701,
2020/6/16,14,21,1723,1702,
2020/6/17,11,20,1713,1693,
2020/6/18,10,24,1718,1694,
2020/6/19,22,27,1749,1722,
2020/6/22,14,17,1744,1727,
2020/6/23,16,28,1772,1744,
2020/6/24,13,16,1769,1753,
2020/6/29,21,34,1753,1719,
2020/6/30,18,24,1768,1744,
2020/7/1,10,24,1762,1738,
2020/7/2,10,44,1798,1754,
2020/7/3,15,19,1811,1792,
2020/7/6,13,35,1826,1791,
2020/7/7,20,43,1816,1773,
2020/7/8,17,20,1810,1790,
2020/7/9,16,26,1814,1788,
2020/7/10,11,26,1789,1763,
2020/7/13,18,36,1820,1784,
2020/7/14,16,28,1819,1791,
2020/7/15,20,31,1860,1829,
2020/7/16,11,26,1847,1821,
2020/7/17,15,33,1816,1783,
2020/7/20,24,26,1789,1763,
2020/7/21,11,19,1781,1762,
2020/7/22,18,18,1777,1759,
2020/7/23,22,28,1779,1751,
2020/7/24,15,56,1771,1715,
2020/7/27,10,15,1745,1730,
2020/7/28,9,28,1754,1726,
2020/7/29,19,36,1765,1729,
2020/7/30,11,15,1758,1743,
2020/7/31,13,18,1734,1716,
2020/8/3,23,34,1715,1681,
2020/8/4,14,18,1710,1692,
2020/8/5,9,35,1706,1671,
2020/8/6,13,20,1698,1678,
2020/8/7,20,24,1710,1686,
2020/8/10,26,27,1742,1715,
2020/8/11,11,12,1734,1722,
2020/8/12,34,48,1758,1710,
2020/8/13,13,21,1760,1739,
2020/8/14,12,26,1758,1732,
2020/8/17,24,24,1750,1726,
2020/8/18,18,27,1933,1906,
2020/8/19,11,14,1932,1918,
2020/8/20,24,24,1922,1898,
2020/8/21,13,19,1928,1909,
2020/8/24,21,21,1948,1927,
2020/8/25,12,15,1953,1938,
2020/8/26,8,25,1967,1942,
2020/8/27,9,10,1965,1955,
2020/8/28,14,20,1955,1935,
2020/8/31,33,37,1991,1954,
2020/9/1,40,63,2043,1980,
2020/9/2,13,22,2050,2028,
2020/9/3,11,15,2038,2023,
2020/9/4,34,66,2058,1992,
2020/9/7,37,37,2079,2042,
2020/9/8,15,35,2056,2021,
2020/9/9,20,22,2004,1982,
2020/9/10,13,34,2008,1974,
2020/9/11,18,21,2005,1984,
2020/9/14,37,37,2036,1999,
2020/9/15,22,41,2115,2074,
2020/9/16,24,24,2092,2068,
2020/9/17,15,35,2114,2079,
2020/9/18,13,17,2084,2067,
2020/9/21,28,41,2087,2046,
2020/9/22,21,24,2032,2008,
2020/9/23,18,20,2016,1996,
2020/9/24,20,39,2017,1978,
2020/9/25,13,16,2023,2007,
2020/9/28,22,44,2034,1990,
2020/9/29,45,45,1998,1953,
2020/9/30,23,48,1965,1917,
2020/10/9,36,39,1993,1954,
2020/10/12,28,44,2037,1993,
2020/10/13,15,26,2043,2017,
2020/10/14,15,23,2055,2032,
2020/10/15,16,40,2064,2024,
2020/10/16,13,38,2076,2038,
2020/10/19,22,57,2088,2031,
2020/10/20,14,19,2040,2021,
2020/10/21,39,83,2146,2063,
2020/10/22,24,24,2099,2075,
2020/10/23,21,42,2088,2046,
2020/10/26,26,29,2032,2003,
2020/10/27,14,28,2032,2004,
2020/10/28,16,37,2063,2026,
2020/10/29,41,44,2063,2019,
2020/10/30,32,60,2065,2005,
2020/11/2,29,45,2030,1985,
2020/11/3,21,40,2068,2028,
2020/11/4,17,41,2087,2046,
2020/11/5,17,22,2064,2042,
2020/11/6,15,46,2091,2045,
2020/11/9,19,19,2084,2065,
2020/11/10,41,41,2136,2095,
2020/11/11,23,48,2201,2153,
2020/11/12,30,43,2186,2143,
2020/11/13,21,81,2256,2175,
2020/11/16,60,67,2291,2224,
2020/11/17,27,45,2260,2215,
2020/11/18,22,34,2256,2222,
2020/11/19,45,73,2323,2250,
2020/11/20,16,21,2293,2272,
2020/11/23,80,88,2351,2263,
2020/11/24,40,40,2307,2267,
2020/11/25,23,37,2341,2304,
2020/11/26,22,75,2294,2219,
2020/11/27,15,40,2265,2225,
2020/11/30,23,35,2277,2242,
2020/12/1,53,56,2321,2265,
2020/12/2,24,39,2319,2280,
2020/12/3,14,50,2285,2235,
2020/12/4,16,38,2261,2223,
2020/12/7,27,48,2282,2234,
2020/12/8,41,55,2280,2225,
2020/12/9,21,41,2277,2236,
2020/12/10,36,43,2331,2288,
2020/12/11,71,111,2441,2330,
2020/12/14,34,43,2489,2446,
2020/12/15,29,70,2524,2454,
2020/12/16,24,29,2513,2484,
2020/12/17,32,33,2511,2478,
2020/12/18,67,73,2562,2489,
2020/12/21,46,54,2549,2495,
2020/12/22,54,91,2558,2467,
2020/12/23,50,70,2455,2385,
2020/12/24,49,53,2541,2488,
2020/12/25,45,60,2511,2451,
2020/12/28,26,118,2462,2344,
2020/12/29,33,62,2378,2316,
2020/12/30,31,36,2374,2338,
2020/12/31,13,49,2402,2353,
2021/1/4,42,51,2418,2367,
2021/1/5,15,27,2418,2391,
2021/1/6,17,65,2436,2371,
2021/1/7,18,33,2389,2356,
2021/1/8,28,76,2369,2293,
2021/1/11,27,47,2369,2322,
2021/1/12,43,71,2352,2281,
2021/1/13,24,51,2384,2333,
2021/1/14,21,41,2347,2306,
2021/1/15,44,63,2343,2280,
2021/1/18,35,58,2345,2287,
2021/1/19,24,47,2349,2302,
2021/1/20,12,55,2316,2261,
2021/1/21,13,49,2328,2279,
2021/1/22,16,32,2344,2312,
2021/1/25,24,67,2340,2273,
2021/1/26,23,57,2293,2236,
2021/1/27,13,23,2259,2236,
2021/1/28,41,41,2269,2228,
2021/1/29,36,62,2317,2255,
2021/2/1,21,30,2320,2290,
2021/2/2,28,52,2305,2253,
2021/2/3,33,46,2276,2230,
2021/2/4,22,37,2321,2284,
2021/2/5,11,19,2338,2319,
2021/2/8,23,46,2358,2312,
2021/2/9,14,33,2338,2305,
2021/2/10,22,35,2283,2248,
2021/2/18,56,66,2360,2294,
2021/2/19,33,55,2398,2343,
2021/2/22,72,72,2462,2390,
2021/2/23,37,68,2484,2416,
2021/2/24,34,34,2471,2437,
2021/2/25,52,66,2562,2496,
2021/2/26,39,55,2498,2443,
2021/3/1,40,90,2584,2494,
2021/3/2,47,70,2540,2470,
2021/3/3,29,53,2558,2505,
2021/3/4,32,52,2557,2505,
2021/3/5,44,80,2581,2501,
2021/3/8,41,68,2681,2613,
2021/3/9,24,51,2632,2581,
2021/3/10,23,62,2521,2459,
2021/3/11,47,47,2468,2421,
2021/3/12,36,51,2484,2433,
2021/3/15,28,73,2485,2412,
2021/3/16,33,34,2475,2441,
2021/3/17,24,44,2450,2406,
2021/3/18,38,46,2422,2376,
2021/3/19,41,88,2376,2288,
2021/3/22,37,38,2346,2308,
2021/3/23,14,38,2365,2327,
2021/3/24,34,34,2368,2334,
2021/3/25,37,41,2360,2319,
2021/3/26,17,32,2366,2334,
2021/3/29,19,37,2398,2361,
2021/3/30,16,29,2443,2414,
2021/3/31,18,55,2430,2375,
2021/4/1,22,36,2396,2360,
2021/4/2,49,79,2442,2363,
2021/4/6,51,51,2466,2415,
2021/4/7,23,27,2480,2453,
2021/4/8,14,38,2468,2430,
2021/4/9,25,63,2484,2421,
2021/4/12,74,102,2446,2344,
2021/4/13,18,38,2394,2356,
2021/4/14,24,45,2435,2390,
2021/4/15,16,60,2481,2421,
2021/4/16,55,55,2470,2415,
2021/4/19,26,31,2475,2444,
2021/4/20,26,39,2478,2439,
2021/4/21,30,34,2425,2391,
2021/4/22,17,37,2425,2388,
2021/4/23,25,45,2407,2362,
2021/4/26,29,53,2460,2407,
2021/4/27,14,42,2479,2437,
2021/4/28,37,44,2442,2398,
2021/4/29,24,48,2469,2421,
2021/4/30,23,32,2464,2432,
2021/5/6,64,95,2543,2448,
2021/5/7,36,59,2580,2521,
2021/5/10,48,49,2612,2563,
2021/5/11,28,70,2588,2518,
2021/5/12,39,132,2707,2575,
2021/5/13,96,169,2852,2683,
2021/5/14,81,166,2806,2640,
2021/5/17,60,96,2755,2659,
2021/5/18,32,70,2723,2653,
2021/5/19,41,50,2670,2620,
2021/5/20,31,64,2582,2518,
2021/5/21,36,52,2538,2486,
2021/5/24,60,84,2595,2511,
2021/5/25,24,56,2623,2567,
2021/5/26,25,152,2696,2544,
2021/5/27,22,76,2642,2566,
2021/5/28,31,82,2636,2554,
2021/5/31,42,62,2605,2543,
2021/6/1,25,37,2575,2538,
2021/6/2,50,67,2562,2495,
2021/6/3,20,47,2563,2516,
2021/6/4,26,39,2535,2496,
2021/6/7,58,83,2520,2437,
2021/6/8,25,35,2447,2412,
2021/6/9,27,40,2466,2426,
2021/6/10,28,45,2473,2428,
2021/6/11,20,42,2466,2424,
2021/6/15,31,83,2517,2434,
2021/6/16,24,29,2535,2506,
2021/6/17,24,32,2519,2487,
2021/6/18,26,44,2485,2441,
2021/6/21,20,43,2475,2432,
2021/6/22,31,71,2533,2462,
2021/6/23,38,65,2589,2524,
2021/6/24,21,36,2588,2552,
2021/6/25,31,37,2596,2559,
2021/6/28,47,49,2564,2515,
2021/6/29,16,29,2565,2536,
2021/6/30,37,74,2630,2556,
2021/7/1,28,39,2595,2556,
2021/7/2,21,37,2596,2559,
2021/7/5,36,39,2650,2611,
2021/7/6,18,39,2658,2619,
2021/7/7,17,37,2569,2532,
2021/7/8,20,37,2557,2520,
2021/7/9,12,63,2595,2532,
2021/7/12,33,36,2635,2599,
2021/7/13,22,32,2648,2616,
2021/7/14,16,54,2675,2621,
2021/7/15,27,41,2645,2604,
2021/7/16,22,49,2729,2680,
2021/7/19,50,71,2755,2684,
2021/7/20,33,57,2748,2691,
2021/7/21,22,59,2722,2663,
2021/7/22,60,68,2778,2710,
2021/7/23,22,76,2763,2687,
2021/7/26,32,47,2699,2652,
2021/7/27,22,36,2695,2659,
2021/7/28,29,40,2665,2625,
2021/7/29,27,36,2688,2652,
2021/7/30,20,66,2786,2720,
2021/8/2,61,74,2755,2681,
2021/8/3,21,58,2671,2613,
2021/8/4,18,25,2646,2621,
2021/8/5,30,49,2662,2613,
2021/8/6,28,65,2647,2582,
2021/8/9,46,48,2605,2557,
2021/8/10,16,52,2645,2593,
2021/8/11,14,22,2670,2648,
2021/8/12,27,36,2704,2668,
2021/8/13,11,19,2689,2670,
2021/8/16,39,66,2876,2810,
2021/8/17,21,40,2872,2832,
2021/8/18,36,52,2894,2842,
2021/8/19,46,46,2843,2797,
2021/8/20,22,35,2812,2777,
2021/8/23,72,145,2925,2780,
2021/8/24,22,91,2914,2823,
2021/8/25,25,33,2879,2846,
2021/8/26,16,48,2833,2785,
2021/8/27,27,28,2822,2794,
2021/8/30,19,40,2824,2784,
2021/8/31,20,59,2830,2771,
2021/9/1,20,98,2859,2761,
2021/9/2,31,70,2902,2832,
2021/9/3,20,35,2902,2867,
2021/9/6,40,48,2931,2883,
2021/9/7,27,98,3065,2967,
2021/9/8,21,71,3079,3008,
2021/9/9,22,80,3116,3036,
2021/9/10,39,105,3108,3003,
2021/9/13,51,109,3144,3035,
2021/9/14,35,69,3059,2990,
2021/9/15,86,139,3112,2973,
2021/9/16,37,94,3205,3111,
2021/10/11,54,54,4013,3959,
2021/10/12,234,234,4235,4001,
2021/10/13,177,339,4113,3774,
2021/10/14,85,196,3883,3687,
2021/10/15,80,182,3823,3641,
2021/10/18,172,265,3913,3648,
2021/10/19,90,141,3867,3726,
2021/10/20,9,9,3484,3475,
2021/10/21,62,251,3531,3280,
2021/10/22,84,250,3370,3120,
2021/10/25,81,104,3265,3161,
2021/10/26,171,171,3216,3045,
2021/10/27,193,233,3105,2872,
2021/10/28,70,250,2894,2644,
2021/10/29,95,131,2904,2773,
2021/11/1,78,116,2979,2863,
2021/11/2,63,202,2867,2665,
2021/11/3,80,185,2950,2765,
2021/11/4,58,112,2907,2795,
2021/11/5,43,106,2873,2767,
2021/11/8,79,122,2920,2798,
2021/11/9,50,79,2845,2766,
2021/11/10,58,130,2734,2604,
2021/11/11,56,124,2774,2650,
2021/11/12,35,134,2678,2544,
2021/11/15,79,97,2593,2496,
2021/11/16,28,63,2606,2543,
2021/11/17,58,94,2593,2499,
2021/11/18,36,78,2567,2489,
2021/11/19,42,123,2641,2518,
2021/11/22,46,58,2671,2613,
2021/11/23,57,89,2728,2639,
2021/11/24,40,72,2781,2709,
2021/11/25,73,96,2761,2665,
2021/11/26,47,96,2727,2631,
2021/11/29,59,93,2684,2591,
2021/11/30,34,50,2662,2612,
2021/12/1,49,90,2719,2629,
2021/12/2,34,56,2681,2625,
2021/12/3,52,73,2651,2578,
2021/12/6,34,61,2714,2653,
2021/12/7,36,92,2710,2618,
2021/12/8,80,86,2660,2574,
2021/12/9,38,106,2677,2571,
2021/12/10,41,66,2672,2606,
2021/12/13,71,109,2729,2620,
2021/12/14,40,40,2725,2685,
2021/12/15,23,23,2586,2563,
2021/12/16,24,104,2650,2546,
2021/12/17,24,38,2689,2651,
2021/12/20,62,111,2718,2607,
2021/12/21,55,60,2616,2556,
2021/12/22,23,68,2598,2530,
2021/12/23,28,31,2579,2548,
2021/12/24,16,61,2645,2584,
2021/12/27,42,83,2611,2528,
2021/12/28,20,57,2561,2504,
2021/12/29,25,31,2559,2528,
2021/12/30,28,40,2559,2519,
2021/12/31,43,53,2527,2474,
2022/1/4,69,92,2607,2515,
2022/1/5,25,33,2591,2558,
2022/1/6,18,60,2621,2561,
2022/1/7,19,63,2644,2581,
2022/1/10,31,59,2662,2603,
2022/1/11,15,35,2573,2538,
2022/1/12,22,33,2586,2553,
2022/1/13,22,44,2638,2594,
2022/1/14,28,77,2717,2640,
2022/1/17,36,36,2723,2687,
2022/1/18,22,107,2777,2670,
2022/1/19,59,94,2880,2786,
2022/1/20,40,42,2830,2788,
2022/1/21,48,79,2823,2744,
2022/1/24,86,95,2860,2765,
2022/1/25,22,52,2786,2734,
2022/1/26,20,69,2845,2776,
2022/1/27,34,54,2858,2804,
2022/1/28,57,97,2902,2805,
2022/2/7,55,75,2979,2904,
2022/2/8,68,78,2986,2908,
2022/2/9,31,76,2891,2815,
2022/2/10,28,58,2822,2764,
2022/2/11,34,89,2794,2705,
2022/2/14,46,64,2801,2737,
2022/2/15,25,44,2778,2734,
2022/2/16,36,55,2776,2721,
2022/2/17,28,38,2719,2681,
2022/2/18,34,74,2783,2709,
2022/2/21,44,46,2790,2744,
2022/2/22,28,83,2846,2763,
2022/2/23,27,47,2834,2787,
2022/2/24,20,69,2873,2804,
2022/2/25,32,143,2852,2709,
2022/2/28,83,88,2908,2820,
2022/3/1,36,70,2950,2880,
2022/3/2,60,104,3068,2964,
2022/3/3,73,125,3159,3034,
2022/3/4,46,119,3142,3023,
2022/3/7,124,176,3324,3148,
2022/3/8,53,106,3314,3208,
2022/3/9,43,125,3369,3244,
2022/3/10,82,111,3129,3018,
2022/3/11,62,76,3159,3083,
2022/3/14,78,113,3100,2987,
2022/3/15,52,91,2996,2905,
2022/3/16,37,54,2962,2908,
2022/3/17,20,56,2941,2885,
2022/3/18,35,35,3030,2995,
2022/3/21,26,72,3077,3005,
2022/3/22,37,56,3133,3077,
2022/3/23,33,49,3096,3047,
2022/3/24,62,104,3128,3024,
2022/3/25,67,109,3130,3021,
2022/3/28,42,85,3165,3080,
2022/3/29,28,49,3077,3028,
2022/3/30,34,42,3041,2999,
2022/3/31,30,87,2977,2890,
2022/4/1,33,48,2926,2878,
2022/4/6,40,67,2976,2909,
2022/4/7,68,68,2991,2923,
2022/4/8,40,66,2913,2847,
2022/4/11,44,64,2838,2774,
2022/4/12,26,45,2854,2809,
2022/4/13,46,46,2885,2839,
2022/4/14,22,42,2905,2863,
2022/4/15,21,78,2941,2863,
2022/4/18,19,38,2995,2957,
2022/4/19,23,54,3023,2969,
2022/4/20,19,54,2994,2940,
2022/4/21,31,39,2966,2927,
2022/4/22,59,82,2952,2870,
2022/4/25,56,86,2800,2714,
2022/4/26,23,47,2763,2716,
2022/4/27,22,114,2765,2651,
2022/4/28,29,44,2712,2668,
2022/4/29,28,56,2728,2672,
2022/5/5,57,102,2797,2695,
2022/5/6,21,36,2794,2758,
2022/5/9,44,44,2713,2669,
2022/5/10,54,74,2670,2596,
2022/5/11,80,90,2706,2616,
2022/5/12,45,83,2745,2662,
2022/5/13,20,65,2775,2710,
2022/5/16,40,40,2801,2761,
2022/5/17,39,46,2812,2766,
2022/5/18,28,60,2746,2686,
2022/5/19,40,52,2732,2680,
2022/5/20,34,82,2784,2702,
2022/5/23,47,53,2823,2770,
2022/5/24,31,62,2787,2725,
2022/5/25,19,55,2740,2685,
2022/5/26,21,83,2805,2722,
2022/5/27,27,34,2823,2789,
2022/5/30,47,59,2829,2770,
2022/5/31,23,66,2849,2783,
2022/6/1,26,82,2883,2801,
2022/6/2,34,34,2871,2837,
2022/6/6,55,55,2902,2847,
2022/6/7,25,42,2904,2862,
2022/6/8,27,33,2961,2928,
2022/6/9,29,78,2964,2886,
2022/6/10,25,39,2926,2887,
2022/6/13,69,73,2947,2874,
2022/6/14,35,69,2955,2886,
2022/6/15,46,112,2952,2840,
2022/6/16,30,49,2844,2795,
2022/6/17,24,31,2787,2756,
2022/6/20,55,78,2744,2666,
2022/6/21,24,53,2721,2668,
2022/6/22,39,73,2717,2644,
2022/6/23,53,86,2685,2599,
2022/6/24,39,106,2646,2540,
2022/6/27,47,54,2593,2539,
2022/6/28,22,46,2637,2591,
2022/6/29,34,52,2658,2606,
2022/6/30,18,29,2654,2625,
2022/7/1,37,71,2605,2534,
2022/7/4,36,58,2565,2507,
2022/7/5,37,37,2582,2545,
2022/7/6,29,58,2495,2437,
2022/7/7,22,108,2574,2466,
2022/7/8,36,75,2558,2483,
2022/7/11,66,133,2506,2373,
2022/7/12,54,64,2378,2314,
2022/7/13,48,53,2363,2310,